||||||||||||||||||||||||||||||||||||||
||||||||||||||f|||||||||||||||||||||||
||********||***|*****|***************|
||**||*****|**||********||||*|||||||*|
||**||||||*|*|**||*|||**|****|||||||*|
||*******|*****|********|****|||||||||
||************||*********************|
||**||||**||**||*|||**|||*||||||||||*|
||*||*****||*******|****|*******||||*|
||**||||||*|*|**||*|||**|****|||||||*|
||*******|*****|********|****|||||||*|
||************||*********************|
||**||||**||**||*|||**|||*||||||||||*|
||*||*****||*******|****|*******||||*|
||||||||||||||||||||||s|||||||||||||||
||||||||||||||||||||||||||||||||||||||
